B P P P P P P P P P P P P P P P P P P P P P P P P P P P P B
P X X X X X X X X X X X X X X X X X X X X X X X X X X X X P
P X B B X X B B X X B B X X B B X X B B X X B B X X B B X P
P X P P X X P P X X P P X X P P X X P P X X P P X X P P X P
P X P P X X P P X X P P X X P P X X P P X X P P X X P P X P
P X P P X X P P X X P P X X P P X X P P X X P P X X P P X P
P X P P X X P P X X P P X X P P X X P P X X P P X X P P X B
P X P P X X P P X X P P X X P P X X P P X X P P X X P P X I
P X P P X X P P X X P P X X P P X X P P X X P P X X P P X B
P X P P X X P P X X P P X X P P X X P P X X P P X X P P X P
P X P P X X P P X X P P X X P P X X P P X X P P X X P P X P
P X B B X X B B X X B B X X B B X X B B X X B B X X B B X P
P X X X X X X X X X X X X X X X X X X X X X X X X X X X X P
P X X X X X X X X X X X X X X X X X X X X X X X X X X X X P
P X B B X X B B X X B B X X B B X X B B X X B B X X B B X P
P X P P X X P P X X P P X X P P X X P P X X P P X X P P X P
P X P P X X P P X X P P X X P P X X P P X X P P X X P P X P
P X P P X X P P X X P P X X P P X X P P X X P P X X P P X B
P X P P X X P P X X P P X X P P X X P P X X P P X X P P X E
P X P P X X P P X X P P X X P P X X P P X X P P X X P P X B
P X P P X X P P X X P P X X P P X X P P X X P P X X P P X P
P X P P X X P P X X P P X X P P X X P P X X P P X X P P X P
P X B B X X B B X X B B X X B B X X B B X X B B X X B B X P
P X X X X X X X X X X X X X X X X X X X X X X X X X X X X P
B P P P P P P P P P P P P P P P P P P P P P P P P P P P P B